20
13
27 27 27 27 27 27 27 27 27 27 27 27 27 27 27 27 27 27 27 27 
27 15 15 15 15 15 15 15 15 15 15 15 15 15 15 15 15 15 15 27 
27 0 0 0 0 0 0 0 0 0 0 0 0 0 0 0 0 0 0 27 
27 0 0 0 0 0 0 0 0 0 0 0 0 0 0 0 0 0 0 27 
27 0 0 0 0 0 0 0 0 0 0 0 0 0 0 0 0 0 0 27 
27 0 0 0 0 0 30 31 0 0 0 0 30 31 0 0 0 0 0 27 
27 0 0 0 0 0 0 0 0 0 0 0 0 0 0 0 0 0 0 27 
27 27 27 31 0 0 0 0 0 30 31 0 0 0 0 0 30 27 27 27 
27 15 15 15 0 0 0 0 0 0 0 0 0 0 0 0 15 15 15 27 
27 0 0 0 0 0 28 29 0 0 0 0 28 29 0 0 0 0 0 27 
27 16 0 0 0 0 27 27 0 0 0 0 27 27 0 0 0 0 16 27 
27 27 27 27 27 27 27 27 27 27 27 27 27 27 27 27 27 27 27 27 
27 27 27 27 27 27 27 27 27 27 27 27 27 27 27 27 27 27 27 27 
